6 12
++++++++++++
++    +  + +
+  +  +    +
+  +  +  + S
+       ++ F
++++++++++++