12 20
++++++++++++++++++++
+                  +
S ++++++++  ++++++ +
+ +              + +
+ +              + +
+ +              + +
+ +      F       + +
+ +              + +
+ +              + +
+ +++++++ ++++++++ +
+   +              +
++++++++++++++++++++
